{
  "21": "lx",
  "22": "lx",
  "23": "lx",
  "24": "lx",
  "25": "lx",
  "26": "lx",
  "27": "lx",
  "28": "lx",
  "29": "lx",
  "30": "lx",
  "31": "lx",
  "32": "lx",
  "33": "lx",
  "34": "lx",
  "35": "lx",
  "36": "lx",
  "37": "lx",
  "38": "lx",
  "39": "lx",
  "40": "lx",
  "41": "lx",
  "42": "lx",
  "43": "lx"
}
